Taimyr 	TAI
Alaskan_Malamute 	AM
Chihuahua 	CHI
Greenland_Sledge_Dog 	GSD
Village_Dog_India-Dehli 	VDID
Samoyed 	SAM
Village_Dog_Brazil 	VDB2
Catahoula_Leopard_Dog 	CLD
Basenji 	BAS2
Beagle 	BEA
Village_Dog_Papua_New_Guinea-Port_Moresby 	VDPNGPM
Village_Dog_Peru-Arequipa 	VDPA
Village_Dog_Vietnam-Lao_Cai 	VDVLC
Village_Dog_Vietnam-Cao_Bang 	VDVCB
Nova_Scotia_Duck_Tolling_Retriever 	NSDTR
Village_Dog_Indonesia-Jakarta 	VDIJ
Village_Dog_Puerto_Rico 	VDPR
American_Eskimo_Dog 	AED
Village_Dog_Peru-Loreto 	VDPL
Village_Dog_Peru-Puno 	VDPP
Boxer 	BOX
Peruvian_Inca_Orchid 	PIO
Xoloitzcuintli 	XOL
Chesapeake_Bay_Retriever 	CBR
New_Guinea_Singing_Dog 	NGSD
Carolina_Dog 	CD
Village_Dog_Peru-Cusco 	VDPC
Village_Dog_Peru-Ica 	VDPI
Village_Dog_Colombia 	VDC
Village_Dog_India-Orissa 	VDIO
Finnish_Spitz 	FS
Village_Dog_Belize 	VDB
Chinese_Shar-pei 	CSP
American_Staffordshire_Terrier 	AST
Village_Dog_Panama 	VDP
Siberian_Husky 	SH
Village_Dog_Costa_Rica 	VDCR
Village_Dog_Papua_New_Guinea-East_Highlands_ 	VDPNGEH
Village_Dog_Dominican_Republic 	VDDR
Village_Dog_India-Mumbai 	VDIM
Eurasier 	EUR
Newfoundland 	NEW
Chow_Chow 	CC
Village_Dog_India-Hazaribagh 	VDIH
Village_Dog_Vietnam-Lang_Son 	VDVLS
Village_Dog_Vietnam-Ha_Giang 	VDVHG
Village_Dog_Honduras 	VDH
American_Pit_Bull_Terrier 	APBT
Village_Dog_Indonesia-Borneo 	VDIB
Village_Dog_India-Chennai 	VDIC
Village_Dog_US-Alaska 	VDUA
